
				NO  ./mur.xpm

    		  C  225,200,0        
        
WE	 ./mur.xpm

EA ./mur.xpm

SO ./mur.xpm

	F  200,100,0



         1111 111111111111111111
        1000010000110000000000001
        1011000001110000000000001
        1001000000000000000000001
11111111101100000111000000000111
100000000011000001110111111111111
11110111111111011100000010001
11110111111111011101010010001
11000000110101011100000010001
10000000000000000000000010001
100000000000000001100010010001
110000011101010111110111100111
10110111 1110101 101001010001
 1111111 1111111 1111011111111
111111111011000001110000N0000011
11111111111111111111111111111111
